AFS: RANDE DA AFRICA DO SUL (TIPO A)
ARB: Peso Argertino
ARS: Peso Argertino
AUD: Dólar comercial australiano
AUS: DÓLAR AUSTRALIANO (TIPO B)
B3SAO: Contrato Futuro de B3SA3
BGI: Boi gordo
BRI: IBrX-50
CAD: Dólar comercial canadense
CAN: DÓLAR CANADENSE (TIPO A)
CCM: Milho
CCROO: Contrato Futuro de CCRO3
CHF: FRANCO SUÍÇO
CHL: PESO CHILENO (TIPO A)
CIELO: Contrato Futuro de CIEL3
CLP: PESO CHILENO
CMIGP: Contrato Futuro de CMIG4
CNH: IUAN CHINÊS (TIPO A)
CNY: IUAN
CPM: CPM – Copom
D13: DI - DI de um dia - séries tipo 3
DAP: Cupom de DI x IPCA
DCO: Cupom Cambial em OC1
DDI: Cupom cambial
DI1: DI de 1 dia
DOL: Dólar comercial
DR1: Rolagem de dólar comercial
DS1: Mini Opção sobre USD
ETH: Etanol Hidratado
EUP: EURO (TIPO B)
EUR: Euro
FRC: FRA de cupom
FRO: FRA de Cupom Cambial em OC1
FRP: Forward points
GBP: Libra Esterlina
GBR: LIBRA ESTERLINA (TIPO B)
HSI: Contrato Futuro de Índice BVMF Hang Seng
HYPEO: Contrato Futuro de HYPE3
ICF: Café Arábica 4/5
IDI: Índice IDI
IMV: Contrato Futuro de Indice Merval
IND: Ibovespa
INK: Contrato Futuro de Indice Nikkei
ISP: S&P 500
JAP: IENE JAPONÊS (TIPO A)
JPY: Iene
JSE: Contrato Futuro de Índice BVMF FTSE/JSE TOP 40
MEX: PESO MEXICANO (TIPO A)
MIX: Contrato Futuro de Índice BVMF MICEX
MXN: Peso mexicano
NOK: COROA NORUEGUESA (TIPO A)
NZD: DÓLAR DA NOVA ZELÂNDIA
NZL: DÓLAR NOVA ZELANDIA (TIPO B)
OC1: Contrato Futuro de OC1
OZ1: Ouro 250g
OZ2: Ouro disponível fracionário 10g
OZ3: Ouro disponível fracionário 0,225g
PETRP: Contrato Futuro de PETR4
PSSAO: Contrato Futuro de PSSA3
RUB: RUBLO RUSSO (TIPO A)
SCS: Swap Cambial (OC1)
SEK: COROA SUECA (TIPO A)
SJC: Soja Financeira Cross Listing
SWI: FRANCO SUIÇO (TIPO A)
T10: US T-Note 10 anos
TRY: LIRA TURCA
TUQ: LIRA TURCA (TIPO A)
USIMA: Contrato Futuro de USIM5
VALEO: Contrato Futuro de VALE3
VVARO: Contrato Futuro de VVAR3
WD1: Rolagem - WD1
WDO: Dólar Mini - WDO
WEU: EURO MÍNI
WIN: Ibovespa Mini
WSP: S&P 500
ZAR: RANDE DA ÁFRICA DO SUL